历史聊天截图	历史聊天截图
加购物车选择配置截图	加购物车选择配置截图
商品局部实拍 （咨询）	商品实拍
商品局部实拍（污损）	商品实拍
订单列表截图	订单截图
展示或摆拍图截图	展示或摆拍图截图
外包装实拍 （咨询）	外包装实拍
优惠券页面截图	优惠券页面截图
退换售后单截图	售后截图
其他售后服务单截图	其他售后服务单截图
退换货物流截图	物流截图
订单物流截图	物流截图
其他场景实拍图 （其他）	其他场景实拍图 （其他）
外包装实拍（污损）	外包装实拍
商品局部实拍（错漏发）	商品实拍
订单详情截图	订单截图
维修售后单截图	售后截图
商品主页面截图	商品主页面截图
尺码信息截图	尺码信息截图
短信截图	短信截图
退款售后截图	售后截图
商品详情截图	商品详情截图
商品整体实拍（错漏发）	商品实拍
商品整体实拍 （咨询）	商品实拍
相似物品实拍 （尺码）	相似物品实拍 （尺码）
push及微信消息截图	push及微信消息截图
其他场景截图	其他场景截图
手机系统截图	手机系统截图
支付订单成功截图	支付订单成功截图
评级评价截图	评级评价截图
文字信息截图	文字信息截图
相似物品实拍（库存）	商品实拍
订单填写截图	订单截图
时效失效售后截图	时效失效售后截图
表情包截图	表情包截图
购物车列表截图	购物车列表截图
订单发票及其他信息截图	订单发票及其他信息截图
商品局部实拍（故障）	商品实拍
赠品实拍 （咨询）	商品实拍
商品整体实拍（污损）	商品实拍
晒单评论截图	晒单评论截图
商品主页信息截图	商品主页面截图
系统应用实拍（屏射）	系统应用实拍（屏射）
其他电脑页面实拍（屏射）	其他电脑页面实拍（屏射）
多个商品列表截图	多个截图
支付订单异常截图	支付订单异常截图
商品整体实拍（故障）	商品实拍
商品app截图	商品app截图
商品app实拍 （屏射）	商品app实拍 （屏射）
多个商品活动截图	多个截图
相似物品实拍（推荐）	商品实拍
相似物品实拍 （比较）	相似物品实拍 （比较）
商品说明书实拍（说明书）	商品说明书实拍（说明书）
价格保护售后截图	价格保护售后截图
商品安装实拍（安装）	商品实拍
赠品实拍（污损）	商品实拍
赠品实拍（错漏发）	商品实拍
赠品实拍（故障）	商品实拍
